back	B AE K
clock	K L AA K
eight	EY T
eleven	IH L EH V AH N
eleven(2)	IY L EH V AH N
five	F AY V
four	F AO R
front	F R AH N T
left	L EH F T
nine	N AY N
o	OW
one	W AH N
one(2)	HH W AH N
picture	P IH K CH ER
right	R AY T
seven	S EH V AH N
side	S AY D
six	S IH K S
take	T EY K
ten	T EH N
three	TH R IY
twelve	T W EH L V
two	T UW
